##########a############################################################################################
#         1                                                                                           #
#         1                                                                                           #
#         1                                                                                           #
#         1                                                                                           #
#         1                                                                                           #
#         1                          11111111111111111                                                #
#         1                          1               1                                                #
#         1                          1               1                                                # 
#         1                          1               1                                                #
#         1                          1               1                                                #
#         1111111111111111111111111111               1                                                #
#                                                    1                                                #
#                                                    1                                                #
#                                                    1                                                #
#                                                    1                                                #
#                                                    1                                                #
#                                                    4444444444444444444444444444444444444444444444444x
#                                                    2                                                #
#                                                    2                                                #
#                                                    2                                                #
#                                                    2                                                #
#                                                    2                                                #
#                      22222222222                   2                                                #
#                      2         2                   2                                                #
#                      2         2                   2                                                #
#                      2         2                   2                                                #
#                      2         222222222222222222222                                                #
#                      2                                                                              #
#                      2                                                                              #
#                      2                                                                              #
#                      2                                                                              #
#                      2                                                                              #
#######################b###############################################################################
-
bullet 8,25
bullet 28,17
explosive 8,4
freezing 24,17
poison 17,47
+
money: 150
win condition: 2
