###############################################################################c#######################
#                                                                              3                      #
#                                                                              3                      #
#                                                                              3                      #
#                                                                              3                      #
#                                                                              3                      #
#                                                                              3                      #
#                                                                              3                      #
#                                                                              33333                  # 
#                                                                                  3                  #
#                                                                                  3                  #
#                                                                                  3                  #
a1111111111111111111111111111111111                                                3                  #
#                                 1                                                3                  #
#                                 1                                                3                  #
#                                 1                                                3                  #
#                                 1                                                3                  #
#                                 11111111111111111111111111111111111111111111111117777777777777777777x
#                                                                                  2                  #
#                                                                                  2                  #
#                                                                                  2                  #
#                                                                                  2                  #
#                                                                                  2                  #
#                                                                                  2                  #
#                                                                                  2                  #
#                                                                                  2                  #
#                                                     222222222222222222222222222222                  #
#                                                     2                                               #
#                                                     2                                               #
#                                                     2                                               #
#                                                     2                                               #
#                                                     2                                               #
#                                                     2                                               #
######################################################b################################################
-
bullet 8,73
bullet 20,60
bullet 23,75
freezing 5,73
freezing 9,9
freezing 29,70
explosive 14,45
bullet 14,90
poison 9,17
poison 28,47
+
money: 200
win condition: 3
