######################a################################################################################
#                     1                                                                               #
#                     1                                                                               #
#                     1                                                                               #
#                     1                                                                               #
#                     1                                                                               #
#                     111111111111111111111111111111111111111111111111111111111111                    #
#                                                                                1                    #
#                                                                                1                    #
#                                                                                1                    #
#                                                                                1                    #
#                                                                                1                    #
#                                                                                1                    #
#                                                                                1                    #
b22222222222222222222222222222222222222222222222222222222222222222222222222222222777777777777777777777x
#                                                                                3                    #
#                                                                                3                    #
#                                                                                3                    #
#                                                                                3                    #
#                                                                                3                    #
#                                                                                3                    #
#                                                                                3                    #
#                                                                                3                    #
#                                                                                3                    #
#                                                                                3                    #
#                     333333333333333333333333333333333333333333333333333333333333                    #
#                     3                                                                               #
#                     3                                                                               #
#                     3                                                                               #
#                     3                                                                               #
#                     3                                                                               #
#                     3                                                                               #
######################c################################################################################
-
bullet 3,28
bullet 17,30
bullet 17,50
bullet 10,87
bullet 20,87
bullet 22,60
explosive 17,12
bullet 28,30
bullet 28,46
poison 3,50
poison 25,16
poison 22,30
freezing 9,25
freezing 10,75
freezing 20,75
+
money: 250
win condition: 4
